                    EA ./path_to_the_east_texture


NO ./path_to_the_north_texture
    SO       ./path_to_the_south_texture           
WE ./path_to_the_west_texture


F 220,100,0
C 225,30,0


111111111
1
1 111
1 1 1111
1   11N1                  
111111111
        1